######################
#                  A #
#   S                #
#                    #
#                    #
#                    #
#                    #
#                A   #
#               ASA  #
#                A   #
######################
