######################
#                    #
#                    #
#                    #
# SAAAA              #
#                    #
#              AAAAS #
#                    #
#                    #
#                    #
######################
